type octile
height 5
width 5
map
T.T..
T..T.
...TT
TT..T
TT...
